###################################
#.................................@
#........#........................@
#.......#.#........#######........@
#......#...#......#.......#.......@
#.....#.....#....#.........#......@
###################################